11111111111
10C00000011
100011100C1
101C000C001
10101111001
1000C000101
11111101001
1000C001E11
10C11101CP1
11111111111