11111111111
1P0000C0011
10001110001
101000000C1
10101111001
1000C000101
11111100101
1C000C00E01
10C11100C01
11111111111