11111111111111111111
10C0000001110C000001
100011100C1100011101
101C000C001101C000C1
10101111000001011111
1000C0001011000C0001
111111010011E1111011
1000C0010111000C0011
10C11101C11P0C110011
11111111111111111111