11111111111
1CCCCCCCC11
1CCC111CCC1
1C1CCCCCCC1
1C1C1111CC1
1CCCCCCC1C1
111111C1CC1
1CCCCCC1E11
1CC111C1CP1
11111111111